  **   ***   *** *  
        *        *  
                 *  
*    *     *     *  
*    *     *        
********************
    *     *     *   
    *     *     *   
                    
 *     *     *      
 *     *     *      
********************
***     ***     *** 
 *       *       *  
 *   *   *   *   *  
     *       *      
    ***     ***     
********************
 **     ***     **  
 *****************  
                    
  ***************   
    ***     ***     
********************
 **   **   **   **  
 **   **   **   **  
    *         *     
    *       ***     
    ***     ***     
********************
 ****         ****  
 ***   *****   ***  
 **   *******   **  
 *   *********   *  
    ***********     
********************
                    
 ***  * *  *   *    
  *  * * *  * *     
  *   * *    *      
 ***   *     *      
********************