  *    *  
 ***  *** 
***** *** 
  *    *  
  *    *  
**********
  ***     
 ***** *  
  *** *** 
   *   *  
   *   *  
**********
   **     
 ******   
 ******   
  ****    
   **     
   **     
**********
   *  *   
  ******  
   *  *   
  ******  
   *  *   
   *  *   
**********
  ** **   
 *  *  *  
  *   *   
   * *    
    *     
**********
  *  *    
  ** *    
  * **    
 **  **   
  * **    
  *  *    
**********

